###################..........#####################
#................................................#
#................................................#
#................................#######.........#
#..##############..............##.......##.......#
#..#............#.............#...........#......#
#..#......................................#......#
#..#............#.............#...........#......#
#..#...........................##.......##.......#
#..#............#................#######.........#
#..##############................................#
#...............................#######..........#
#.............................##.......##.........
#............................#...........#........
#..##############........................#........
#..#.........................#...........#........
#..#............#.............##.......##.........
#..#............#...............#######...........
#..#..............................................
#..##############.................................
#.................................................
#...................#.#...........................
#..................#...#..........................
#.................#.....#........................#
#................#.......#.......................#
#................#.......#.......................#
#................#.......#.......................#
#................#.......#.......................#
#................#.......#.......................#
#.................#.....#........................#
#..................#...#.........................#
#...................###..........................#
#................................................#
#................................................#
#####....###########################........######