##################################################
#................................................#
#................................................#
#................................................#
#................................................#
#...................############.................#
#...................#..........#.................#
#...................#..........#.................#
#...................#..........#.................#
#...................#..........#.................#
#...................#..........#.................#
#...................#..........#.................#
............#########..........########..........#
............#.........................#..........#
......................................#..........#
......................................#..........#
............#.........................#..........#
............#.........................#..........#
............#.........................#..........#
......................................#..........#
......................................#..........#
............#.........................#..........#
............#########..........########..........#
#...................#..........#.................#
#...................#..........#.................#
#...................#..........#.................#
#...................#..........#.................#
#...................#..........#.................#
#...................#..........#.................#
#...................#..........#.................#
#...................#..........#.................#
#...................############.................#
#................................................#
#................................................#
##################################################