#................................................#
#................................................#
#................................................#
#................................................#
#..................................#####.........#
#.................................#.....#........#
#.....##.##......................#.......#.......#
#....#.....#....................#.........#......#
#...#.......#.............................#......#
#..#.........#..................#.........#......#
#..#.........#............................#......#
#..#.........#..................#.........#......#
#..#.........#...................#.......#.......#
#..#.........#....................#.....#........#
#...#.......#......................#####.........#
#....#.....#.....................................#
#.....#####......................................#
#................................................#
#..................#.#.#.........................#
#................##.....##.......................#
#...............#.........#..........#.#.........#
#...#.#........#...........#........#...#........#
#..#...#.......#...........#.......#.....#.......#
#.#.....#......#...........#......#.......#......#
#.#.....#.......#.........#...............#......#
#.#.....#........##.....##........#.......#......#
#..#...#...........#####..................#......#
#...###...........................#.......#......#
#..................................#.....#.......#
#...................................#...#........#
#....................................###.........#
#................................................#
#................................................#
#................................................#
##################################################