##################################################
##################################################
####################.#############################
##################.....###########################
######...#########.......#########################
#####.....#########.......########################
####.......#####...........##########...##########
####............#####......#########.....#########
####.......##########......#########.....#########
####.......##########....###########.....#########
####........#########....##########.....##########
#####.......#########...##########..###..#########
######...#...#########..#########..####..#########
###########..#########..########...####..#########
###########...########..#######...######.#########
############...#######..#######..#######.#########
############....######..####...#########..########
###############..##.....###...#####.####..########
################........#...#####.....##..########
#################..........#####.####......#######
################....<....#####..########..########
################.........###..#########..#########
################............########.....#########
####......######........###########.....##########
###.............#.......##########.......#########
###..........######...############.......#########
###..........########..###########.......#########
###..........########...######..###.....##########
###...........#######...........####...###########
####...........########.........#####.############
#####..........###############...####.############
######...######################..###..############
###############################...##..############
#################################.....############
##################################.###############