..............####################################
............######################################
...........#######################################
..........########################################
........##########################################
....##..##########################################
..#####..#########################################
#######...########################################
########...#######################################
########....######################################
########....######################################
#########...######################################
##########...#####################################
###########....###################################
############....##################################
#############...#####..###########################
##############....#.....##########################
###############..........#########################
###############..........#########################
###############...........########################
###############.....>.....########################
##############...........#########################
##############...........#########################
##############.......##.##########################
###############..##.##############################
##################################################
##################################################
##################################################
##################################################
##################################################
##################################################
##################################################
##################################################
##################################################
##################################################